w,w,w,w,w,w,w,w,w,w
w,e,f,t,f,f,f,z,f,w
w,f,f,f,f,b,z,f,f,w
w,f,f,t,f,f,f,t,f,w
w,z,f,b,t,f,b,f,f,w
w,f,f,z,f,f,f,f,f,w
w,z,f,t,f,f,f,f,t,w
w,f,f,f,f,t,f,f,f,w
w,f,f,f,f,f,f,f,p,w
w,w,w,w,w,w,w,w,w,w