w,w,w,w,w,w,w,w,w,w
w,e,f,z,f,f,f,f,f,w
w,f,b,b,f,f,f,f,f,w
w,f,f,f,f,f,f,b,f,w
w,f,f,b,t,f,f,f,f,w
w,z,f,f,f,f,f,z,f,w
w,t,f,t,f,f,f,f,f,w
w,f,f,f,f,f,t,f,f,w
w,z,f,f,f,f,f,f,p,w
w,w,w,w,w,w,w,w,w,w